1 1 1 1 1 1 
1 0 4 0 0 1
1 4 3 0 0 1
1 0 3 2 0 1
1 0 0 0 0 1
1 1 1 1 1 1
3 3 2 2 2 1 3 2 1 2